1,1,1,1,1,1,1,1,1,1,1,1,1,1,1,1,1,1
1,5,0,0,1,0,0,0,0,0,0,0,0,1,0,0,5,1
1,0,1,0,0,0,1,1,0,0,1,1,0,0,0,1,0,1
1,0,1,1,0,1,0,0,0,0,0,0,1,0,1,1,0,1
1,0,0,1,0,0,0,3,4,4,3,0,0,0,1,0,0,1
1,1,0,1,1,0,3,3,3,3,3,3,0,1,1,0,1,1
7,2,0,0,0,0,3,3,3,3,3,3,0,0,0,0,0,7
1,1,0,1,1,0,0,0,0,0,0,0,0,1,1,0,1,1
1,1,0,1,1,1,1,1,0,0,1,1,1,1,1,0,1,1
1,0,0,0,1,1,0,0,0,0,0,0,1,1,0,0,0,1
1,0,1,0,0,0,0,1,1,1,1,0,0,0,0,1,0,1
1,5,0,0,1,1,0,0,0,0,0,0,1,1,0,0,5,1
1,1,1,1,1,1,1,1,1,1,1,1,1,1,1,1,1,1