111111111111111111
150010000000010051
101000110011000101
101101000000101101
100100034430001001
110110333333011011
720000333333000007
110110000000011011
110111110011111011
100011000000110001
101000011110000101
150011000000110051
111111111111111111