111111111111111111
140010000000010041
101000110011000101
101101000000101101
100100033330001001
110110333333011011
020000333333000000
110110000000011011
110111110011111011
100011000000110001
101000011110000101
140011000000110041
111111111111111111